............................
............................
............................
1111111111111111111111111111
1222222222222112222222222221
1211112111112112111112111121
131..121...121121...121..131
1211112111112112111112111121
1222222222222222222222222221
1211112112111111112112111121
1211112112111111112112111121
1222222112222112222112222221
1111112111110110111112111111
.....121111101101111121.....
.....121100000C00001121.....
.....12110111**11101121.....
1111112110100000010112111111
00000020001B0N0I010002000000
1111112110100000010112111111
.....121101111111101121.....
.....121100000000001121.....
.....121101111111101121.....
1111112110111111110112111111
1222222222222112222222222221
1211112111112112111112111121
1211112111112112111112111121
1322112222222P02222222112231
1112112112111111112112112111
1112112112111111112112112111
1222222112222112222112222221
1211111111112112111111111121
1211111111112112111111111121
1222222222222222222222222221
1111111111111111111111111111
............................
............................